8,7,6,5,8,7,5,6,6,7
5,8,5,6,5,6,5,6,5,6
6,4,6,1,1,1,1,1,1,8
5,6,0,0,0,1,0,0,0,1
1,1,0,1,0,1,0,1,0,1
1,1,0,1,0,1,0,1,0,5
2,0,0,1,0,0,0,1,0,6
5,1,1,1,1,1,1,1,0,3
6,5,1,1,1,1,1,1,1,7
8,6,7,5,6,7,8,5,7,8
