6,5,5,6,5,5,6,5,5,7
6,5,1,5,5,5,5,5,5,5
5,4,5,1,1,5,1,1,1,1
1,5,1,1,0,0,0,0,0,3
1,1,1,1,0,1,1,0,1,1
1,1,0,0,0,1,1,0,1,1
2,0,0,1,0,0,0,0,1,5
1,1,1,5,1,1,5,1,1,5
1,1,1,5,1,5,1,5,5,5
1,1,5,6,5,5,5,6,5,7
