5,6,1,1,5,1,1,1,6,1,2,1
2,0,0,0,0,0,0,0,0,0,0,1
1,5,6,1,1,6,1,5,1,1,0,1
1,0,0,0,0,0,0,0,0,0,0,6
6,0,1,5,1,1,1,5,6,1,1,5
1,0,1,0,0,0,0,0,0,0,0,1
5,0,1,0,1,5,1,6,1,1,0,6
6,0,5,0,1,4,0,0,0,1,0,5
1,0,1,0,6,1,0,1,0,5,0,6
1,0,1,0,1,5,0,1,0,1,0,1
5,0,0,0,1,1,0,1,0,0,0,1
5,6,1,1,5,6,3,1,6,5,5,6
