7,6,5,4,7,6,4,5,5,6
4,7,4,5,4,5,4,5,4,5
5,8,5,1,1,1,1,1,1,7
4,5,0,0,0,1,0,0,0,1
1,1,0,1,0,1,0,1,0,1
1,1,0,1,0,1,0,1,0,4
2,0,0,1,0,0,0,1,0,5
4,1,1,1,1,1,1,1,0,3
5,4,1,1,1,1,1,1,1,6
7,5,6,4,5,6,7,4,6,7
